2020202020202020202020202020202020202020
2000000000000000000000000000000000000020
2000202020002020200020202000202020000020
2000002000002020200000200000200020000020
2000002000002000200000200000202020000020
2000000000000000000000000000000000000020
2000000000000000000000000000000000000020
2000000000000000000000000000000000000020
2000000000000000000000000000000000000020
2000000000000000000000000000000000000020
2000000000000000000000000000000000000020
2000000000000000000000000000000000000020
2000000000000000000000000000000000000020
2000000000000000000000000000000000000020
2000000000000000000000000000000000000020
2020202020202020202020202020202020202020

image image:tiles
hero @4,5
sprite @5,5 sprite:8 (u32)0
position 128 128
sprite @9,6 sprite:testing (u16)ABC (u16)XYZ
