0100003031313200000000000000000010111111111111111111111112000000000000000000000000343300303114
0000000000000000000000000000000030313131313131311421211332000000000000000000000000000000000020
0038003800383838003800000038000000003800000000002021212200000000000000000000000000000000000020
0038003800380000003800000038000000380038001012002021212201000000000000000000000000000000000020
0038383800383800003800000038000000380038003032002021212311120000000000000000000000000000000030
0038003800380000003800000038000000380038000000002021212121220000000000000000000000000000000000
0038003800383838003838380038383800003800000000102421133131320000000000000000000000000000000034
0000000000000000000000000000000000000000000010242121220000000000000000000000000000000000000034
0000000000000000000000000000000000000000000030313131320000000000000000000000000000000000000033
0000000000000000000000000000000000000000000000000000000000000000000000000000000000000000000000
0000000000000000000000000000000000000000000000000000000000000000000000000000000000000000000000
0000000000000000000000000000000000000000000001000000330000000000000000000000000000000000000000
0000000000000000000000000000000000000000000110000000330000000000000000000000000000000000000000
0000000000000000000000000000000000000000010010000000000000000000000000000000000000000000000000
0000000000000000000000000000000000000001000010000000000000000000000000000000000000000000000000
0000000000000000000000000000000000000100000010000000636363000000000000000000000000000000000000
0000000000000000000000000000000000010000000010000000636363000000000000000000000000000000000000
0000000000000000000000000000000001000000000100000000636363000000000000000000000000000000000000
0000000000000000000000000000000100000000000100000000000000000000000000000000000000000000000000
0000000000000000000000000000010000101010000100000000525354000000000000000000000000000000000000
0000000000000000000000000001000000100110001011120000626364000000000000000000000000000000000000
0000000000000000000000000100000000101010002013320000727374000000000000000000000000000000000000
0000000000000000000000010000000000000000002022000000000000000000000000000000000000000000000000
0000000000000000000001000000000000000000003032000000000000003838380000000000000000000000000000
0000000000000000000100000000000000000000010000000000000000000000000000000000000000000000000000
0000000000000000010000000000000000000000010000000000000000380002003800000000000000000000000000
0000000000000001000000000000000000000000010000000000000000380000003800000000000000000000000000
1200000000000100000000000000000100000000100000000000000000383838383800000000000000000000000000
2200000000010000000000000000010100000000100000000000000000000000000000000000000000000000000003
2200000001000000000000000000000000000000100000000000000000000000000000000000000000000000000003
3200000100000000000000000000000000000001000000000000000000000000000000000000000000000000000003
0000010000000000000000000000000000000001000000000000000000000000000000000000000000000000000003
0001000000000000000000000000000000000001000000000000000000000000000000000000000000000000000000
1100000000030000000000000000000000000033343434330010111200343300000000000000000000000003000020

image image:tiles
