00000000000000000000000000000000000000000000000000000000000000000000000000000000000000000000000000
00000000000000000000000000000000000000000000000000000000000000000000000000000000000000000000000000
00000000000000000000000000000000000000000000000000000000000000000000000000000000000000000000000000
00000000000000000000000000000000000000000000000000000000000000000000000000000000000000000000000000
00000000000000000000000000000000000000000000000000000000000000000000000000000000000000000000000000
00000000000000000000000000000000000000000000000000000000000000000000000000000000000000000000000000
00000100003334343400000000000000000010111111111111111111111112000000000000000000000000333300333310
00000000000000000000000000000000000030313131313131311421211332000000000000000000000000000000000020
00000038003900383838003900000038000000003900000000002021212200000000000000000000000000000000000020
00000039003900390000003900000038000000390039001012002021212201000000000000000000000000000000000020
00000039393800393800003800000038000000380038003032002021212311120000000000000000000000000000000030
00000039003800390000000000000000000000000039000000002021212121220000000000000000000000000000000000
00000038003900393838000000000000000000003900000000102421133131320000000000000000000000000000000010
00000000000000000000390000003800000038000000000034202121220000000000000000000000000000000000000020
00000000000000000000390039000038000000000000000000303131320000000000000000000000000000000000000030
00000000000000000000000000000000000000000000000000000000000000000000000000000000000000000000000000
00000000000000000000000000000000000000000000000000000000000000001011120000000000000000000000000000
00000000000000000000000000003400000000000000000000000000000000002021231200101200000000000000000000
00000000000000000000000000000000000000000000000000000000000000003014212311242200000000000000000000
00000000000000000000000100000000000000000000000000000000000000000020212121212200000000000000000000
00000000000000000000000100000000000000000000000000000000000000340020212121212200000000000000000000
00000000000000000000000100000000000000000000010000000000006300000020212121212200000000000000000000
00000000000000000000000000000000000000000000000100000000000000000030142113313200000000000000000000
00000000000000000000000000010000000000000000000000000000000000000000301422000000000000000000000000
00000000000000000000000000000000000000000000000000000000000000000000003032000000000000000000000000
00000000000000000000000000000000010000000000000000000000525354000000000000000000000000000000000000
00000000000000000000000000000001000000000000000010120000626364000000000000000000000000000000000000
00000000000000000000000000000100000000000000000030320000727374000000000000000000000000000000000000
00000000000000000000000000010000000033013300001012000000000000000000000000000000000000000000000000
00000000000000000000000001000000000033333400003032000000000000003938390000000000000000000000000000
00000000000000000000000100000000000000000000010000000000000000000000000000000000000000000000000000
00000000000000000000010000000000000000000000010000000000000000390002003900000000000000000000000000
00000000000000000001000000000000000000000000010000000000000000380000003800000000000000000000000000
00003400000000000100000000000000000100000000340000000000000000383938393900000000000000000000000000
00003400000000010000000000000000010100000000340000000000000000000000000000000000000000000000000003
00003400000001000000000000000000000000000000330000000000000000000000000000000000000000000000000003
00003300000100000000000000000000000000000001000000000000000000000000000000000000000000000000000003
00000000010000000000000000000000000000000001000000000000000000000000000000000000000000000000000003
00000001000000000000000000000000000000000001000000000000000000000000000000000000000000000000000000
00003300000000030000000000000000000000000010111111120010111200101200000000000000000000000003000010

image image:tiles
sprite @19,26 sprite:hero
sprite @26,28 sprite:devil
thingy @28,23
sprite @25,24 sprite:devil
thingy @29,26
door @33,31 map:another @8,3
door @26,32 map:another @1,3
