3030303030303030303030303030303030303030
3030303030303030303030303030303030303030
3030202020302020203020202030202020303030
3030302030302020203030203030203020303030
3030302030302030203030203030202020303030
3030303030303030303030303030303030303030
3030303030303030303030303030303030303030
3030303030303030303031323232323233303030
3030303030303030303041424242424243303030
3030303030303030303041424242424243303030
3030303030303030303041424242424243303030
3030303030303030303051525252505253303030
3030303030303030303030303030303030303030
3030303030303030303030303030303030303030
3030303030303030303030303030303030303030
3030303030303030303030303030303030303030

image image:tiles
hero @4,5
sprite @5,5 sprite:8 (u32)0
position 128 128
sprite @9,6 sprite:testing (u16)ABC (u16)XYZ
