0000000000000000000000000000000000000000
0000000000000000000000000000000000000000
0000000000000000000000000000000000000000
0000000000000000000000000000000000000000
0000002121210000000000000000000000000000
0000000000210000002121210000000000000000
0000000000210000002100000000000000000000
0000002121210000002121000000000000000000
0000002100000000002100000000000000000000
0000002100000000002121210000000000000000
0000002121210000000000000000000000000000
0000000000000000000000000000000000000000
0000000000000000000000000000000000000000
0000000000000000000000000000000000000000
0000000000000000000000000000000000000000
0000000000000000000000000000000000000000

image image:tiles
position 129 128
