0000000000000000000000000000000000000000
0000000000000000000000000000000000000000
0000000000000000000000000000000000000000
0000212121210000000000000000000000000000
0000000000210000000000000000000000000000
0000000000210000210000002100000000000000
0000000021210000212100002100000000000000
0000000000210000210021002100000000000000
0000000000210000210000212100000000000000
0000212121210000210000002100000000000000
0000000000000000000000000000000000000000
0000000000000000000000000000000000000000
0000000000000000000000000000000000000000
0000000000000000000000000000000000000000
0000000000000000000000000000000000000000
0000000000000000000000000000000000000000

image image:tiles
position 128 127
