9191919191919191919191919191919191919191
9183a1a1a1a1a1a1a1a1a1a1a1a1a1a1a1a18491
9192868787878787878787878787878787889091
919296979797979789a7a7a7a7a78a9797989091
919296979789a7a7a88081818182a68a97989091
9192969797988081819491919193829697989091
a1a2969797989091919191919191929697989091
87879a979798a0a1a18491919191929697989091
a7a78a9797998787889091919183a29697989091
8182969795aba59798a0a1a1a1a2869a97989091
919296978b8bab979987878787879a9797989091
91929697958ba597979797979797979797989091
9192969797979797979797979797979797989091
9192a6a7a7a7a7a78a89a7a7a7a7a7a7a7a89091
9193818181818182969880818181818181819491
9191919191919192969890919191919191919191

image image:tiles
neighbors map:another 0x0000 0x0000 map:east
