0000000000000000000000000000000000000000
0000000000000000000000000000000000000000
0000000000000000000000000000000000000000
0021212100210000000000000000000000000000
0021002100210021210000000000000000000000
0021002121210021000000000000000000000000
0000000000000021210000000000000000000000
0000000000000021000000000000000000000000
0000000000000021210000000000000000000000
0000000000000000000000000000000000000000
0000000000000000000000000000000000000000
0000000000000000000000000000000000000000
0000000000000000000000000000000000000000
0000000000000000000000000000000000000000
0000000000000000000000000000000000000000
0000000000000000000000000000000000000000

image image:tiles
position 129 127
