2121212121212121212121212121212121212121
2113313131313131313131313131313131311421
2122000000000000000000000000000000002021
2122000000000000000000000000000000002021
2122000000000000000000000000000000002021
2122000000000000000000000000000000002021
3132000000000000000000000000000000002021
0000000000000000000000000000000000002021
0000000000000000000000000000000000002021
1112000000000000000000000000000000002021
2122000000000000000000000000000000002021
2122000000000000000000000000000000002021
2122000000000000000000000000000000002021
2122000000000000000000000000000000002021
2123111111111112000010111111111111112421
2121212121212122000020212121212121212121

image image:tiles
neighbors map:another 0x0000 0x0000 map:east
